1,1,1,1,1,1,1,1,1,1,1,1,1,1,1,1,1,1,1,1,1,1,1,1,1,1,1,1,1,1,1,
1,1,1,1,1,1,1,1,1,1,1,1,1,1,1,1,1,1,1,1,1,1,1,1,1,1,1,1,1,1,1,
1,1,1,1,1,1,1,1,1,1,1,1,1,1,1,1,1,1,1,1,1,1,1,1,1,1,1,1,1,1,1,
1,1,1,1,1,1,1,1,1,1,1,1,1,1,1,1,1,1,1,1,1,1,1,1,1,1,1,1,1,1,1,
1,1,1,1,1,1,1,1,1,1,1,1,1,1,1,1,1,1,1,1,1,1,1,1,1,1,1,1,1,1,1,
1,1,1,1,1,1,1,1,1,1,1,1,1,1,1,1,1,1,1,1,1,1,1,1,1,1,1,1,1,1,1,
1,1,1,1,1,1,1,1,1,1,1,1,1,1,1,1,1,1,1,1,1,1,1,1,1,1,1,1,1,1,1,
1,1,1,1,1,1,1,1,1,1,1,1,1,1,1,1,1,1,1,1,1,1,1,1,1,1,1,1,1,1,1,
1,1,1,1,1,1,1,1,1,1,13,13,13,13,13,13,13,13,13,13,13,1,1,1,1,1,1,1,1,1,1,
1,1,1,1,1,1,1,1,1,1,13,14,15,14,13,14,14,15,14,14,13,1,1,1,1,1,1,1,1,1,1,
1,1,1,1,1,1,1,1,1,1,13,16,16,16,13,16,23,16,23,16,13,1,1,1,1,1,1,1,1,1,1,
1,1,1,1,1,1,1,1,1,1,13,21,7,21,13,11,24,7,24,12,13,1,1,1,1,1,1,1,1,1,1,
1,1,1,1,1,1,1,1,1,1,13,22,7,22,14,7,7,8,7,7,13,1,1,1,1,1,1,1,1,1,1,
1,1,1,1,1,1,1,1,1,1,13,7,7,7,16,7,8,10,8,7,13,1,1,1,1,1,1,1,1,1,1,
1,1,1,1,1,1,1,1,1,1,13,7,7,7,7,7,7,8,7,7,13,1,1,1,1,1,1,1,1,1,1,
1,1,1,1,1,1,1,1,1,1,13,7,7,7,7,7,7,7,7,11,13,1,1,1,1,1,1,1,1,1,1,
1,1,1,1,1,1,1,1,1,1,13,13,13,13,13,13,13,13,13,13,13,1,1,1,1,1,1,1,1,1,1,
1,1,1,1,1,1,1,1,1,1,14,14,14,14,15,25,15,14,14,14,14,1,1,1,1,1,1,1,1,1,1,
1,1,1,1,1,1,1,1,1,1,16,16,16,16,16,26,16,16,16,16,16,1,1,1,1,1,1,1,1,1,1,
1,1,1,1,1,1,1,1,1,1,1,1,1,1,1,1,1,1,1,1,1,1,1,1,1,1,1,1,1,1,1,
1,1,1,1,1,1,1,1,1,1,1,1,1,1,1,1,1,1,1,1,1,1,1,1,1,1,1,1,1,1,1,
1,1,1,1,1,1,1,1,1,1,1,1,1,1,1,1,1,1,1,1,1,1,1,1,1,1,1,1,1,1,1,
1,1,1,1,1,1,1,1,1,1,1,1,1,1,1,1,1,1,1,1,1,1,1,1,1,1,1,1,1,1,1,
1,1,1,1,1,1,1,1,1,1,1,1,1,1,1,1,1,1,1,1,1,1,1,1,1,1,1,1,1,1,1,
1,1,1,1,1,1,1,1,1,1,1,1,1,1,1,1,1,1,1,1,1,1,1,1,1,1,1,1,1,1,1,
1,1,1,1,1,1,1,1,1,1,1,1,1,1,1,1,1,1,1,1,1,1,1,1,1,1,1,1,1,1,1,
1,1,1,1,1,1,1,1,1,1,1,1,1,1,1,1,1,1,1,1,1,1,1,1,1,1,1,1,1,1,1,