1,1,1,1,1,1,1,1,1,1,1,1,1,1,1,1,1,1,1,1,1,1,1,1,1,1,1,1,1,1,1,
1,1,1,1,1,1,1,1,1,1,1,1,1,1,1,1,1,1,1,1,1,1,1,1,1,1,1,1,1,1,1,
1,1,1,1,1,1,1,1,1,1,1,1,1,1,1,1,1,1,1,1,1,1,1,1,1,1,1,1,1,1,1,
1,1,1,1,1,1,1,1,1,1,1,1,1,1,1,1,1,1,1,1,1,1,1,1,1,1,1,1,1,1,1,
1,1,1,1,1,1,1,1,1,1,1,1,1,1,1,1,1,1,1,1,1,1,1,1,1,1,1,1,1,1,1,
1,1,1,1,1,1,1,1,1,1,1,1,1,1,1,1,1,1,1,1,1,1,1,1,1,1,1,1,1,1,1,
1,1,1,1,1,1,1,1,1,1,1,1,1,1,1,1,1,1,1,1,1,1,1,1,1,1,1,1,1,1,1,
1,1,1,1,1,1,1,1,1,1,1,1,1,1,1,1,1,1,1,1,1,1,1,1,1,1,1,1,1,1,1,
1,1,1,1,1,1,1,1,1,1,13,13,13,13,13,1,13,13,13,13,13,1,1,1,1,1,1,1,1,1,1,
1,1,1,1,1,1,1,1,1,1,13,14,14,15,14,17,14,15,14,14,13,1,1,1,1,1,1,1,1,1,1,
1,1,1,1,1,1,1,1,1,1,13,16,23,16,16,18,16,16,23,16,13,1,1,1,1,1,1,1,1,1,1,
1,1,1,1,1,1,1,1,1,1,13,7,24,7,11,7,11,7,24,7,13,1,1,1,1,1,1,1,1,1,1,
1,1,1,1,1,1,1,1,1,1,13,7,7,7,7,8,7,7,7,7,13,1,1,1,1,1,1,1,1,1,1,
1,1,1,1,1,1,1,1,1,1,13,7,7,7,8,10,8,7,7,7,13,1,1,1,1,1,1,1,1,1,1,
1,1,1,1,1,1,1,1,1,1,13,7,7,7,7,8,7,7,7,9,13,1,1,1,1,1,1,1,1,1,1,
1,1,1,1,1,1,1,1,1,1,13,7,7,11,7,7,7,11,9,7,13,1,1,1,1,1,1,1,1,1,1,
1,1,1,1,1,1,1,1,1,1,13,13,13,13,13,13,13,13,13,13,13,1,1,1,1,1,1,1,1,1,1,
1,1,1,1,1,1,1,1,1,1,14,14,14,14,15,25,15,14,14,14,14,1,1,1,1,1,1,1,1,1,1,
1,1,1,1,1,1,1,1,1,1,16,16,16,16,16,26,16,16,16,16,16,1,1,1,1,1,1,1,1,1,1,
1,1,1,1,1,1,1,1,1,1,1,1,1,1,1,1,1,1,1,1,1,1,1,1,1,1,1,1,1,1,1,
1,1,1,1,1,1,1,1,1,1,1,1,1,1,1,1,1,1,1,1,1,1,1,1,1,1,1,1,1,1,1,
1,1,1,1,1,1,1,1,1,1,1,1,1,1,1,1,1,1,1,1,1,1,1,1,1,1,1,1,1,1,1,
1,1,1,1,1,1,1,1,1,1,1,1,1,1,1,1,1,1,1,1,1,1,1,1,1,1,1,1,1,1,1,
1,1,1,1,1,1,1,1,1,1,1,1,1,1,1,1,1,1,1,1,1,1,1,1,1,1,1,1,1,1,1,
1,1,1,1,1,1,1,1,1,1,1,1,1,1,1,1,1,1,1,1,1,1,1,1,1,1,1,1,1,1,1,
1,1,1,1,1,1,1,1,1,1,1,1,1,1,1,1,1,1,1,1,1,1,1,1,1,1,1,1,1,1,1,
1,1,1,1,1,1,1,1,1,1,1,1,1,1,1,1,1,1,1,1,1,1,1,1,1,1,1,1,1,1,1,