1,1,1,1,1,1,1,1,1,1,1,1,1,1,1,1,1,1,1,1,1,1,1,1,1,1,1,1,1,1,1,
1,1,1,1,1,1,1,1,1,1,1,1,1,1,1,1,1,1,1,1,1,1,1,1,1,1,1,1,1,1,1,
1,1,1,1,1,1,1,1,1,1,1,1,1,1,1,1,1,1,1,1,1,1,1,1,1,1,1,1,1,1,1,
1,1,1,1,1,1,1,1,1,1,1,1,1,1,1,1,1,1,1,1,1,1,1,1,1,1,1,1,1,1,1,
1,1,1,1,1,1,1,1,1,1,1,1,1,1,1,1,1,1,1,1,1,1,1,1,1,1,1,1,1,1,1,
1,1,1,1,1,1,1,1,1,1,1,1,1,1,1,1,1,1,1,1,1,1,1,1,1,1,1,1,1,1,1,
1,1,1,1,1,1,1,1,1,1,1,1,1,1,1,1,1,1,1,1,1,1,1,1,1,1,1,1,1,1,1,
1,1,1,1,1,1,1,1,1,1,1,1,1,1,1,1,1,1,1,1,1,1,1,1,1,1,1,1,1,1,1,
1,1,1,1,1,1,1,1,1,1,13,13,13,13,13,13,13,13,13,13,13,1,1,1,1,1,1,1,1,1,1,
1,1,1,1,1,1,1,1,1,1,13,14,25,14,13,14,13,14,25,14,13,1,1,1,1,1,1,1,1,1,1,
1,1,1,1,1,1,1,1,1,1,13,16,16,16,13,23,13,16,16,16,13,1,1,1,1,1,1,1,1,1,1,
1,1,1,1,1,1,1,1,1,1,13,21,7,21,14,24,14,12,9,12,13,1,1,1,1,1,1,1,1,1,1,
1,1,1,1,1,1,1,1,1,1,13,22,7,22,16,7,16,7,8,7,13,1,1,1,1,1,1,1,1,1,1,
1,1,1,1,1,1,1,1,1,1,13,7,7,7,7,7,7,8,10,8,13,1,1,1,1,1,1,1,1,1,1,
1,1,1,1,1,1,1,1,1,1,13,7,21,7,13,7,13,7,8,7,13,1,1,1,1,1,1,1,1,1,1,
1,1,1,1,1,1,1,1,1,1,13,7,22,7,13,7,13,11,7,11,13,1,1,1,1,1,1,1,1,1,1,
1,1,1,1,1,1,1,1,1,1,13,13,13,13,13,13,13,13,13,13,13,1,1,1,1,1,1,1,1,1,1,
1,1,1,1,1,1,1,1,1,1,14,14,14,14,14,25,14,14,14,14,14,1,1,1,1,1,1,1,1,1,1,
1,1,1,1,1,1,1,1,1,1,16,16,16,16,16,26,16,16,16,16,16,1,1,1,1,1,1,1,1,1,1,
1,1,1,1,1,1,1,1,1,1,1,1,1,1,1,1,1,1,1,1,1,1,1,1,1,1,1,1,1,1,1,
1,1,1,1,1,1,1,1,1,1,1,1,1,1,1,1,1,1,1,1,1,1,1,1,1,1,1,1,1,1,1,
1,1,1,1,1,1,1,1,1,1,1,1,1,1,1,1,1,1,1,1,1,1,1,1,1,1,1,1,1,1,1,
1,1,1,1,1,1,1,1,1,1,1,1,1,1,1,1,1,1,1,1,1,1,1,1,1,1,1,1,1,1,1,
1,1,1,1,1,1,1,1,1,1,1,1,1,1,1,1,1,1,1,1,1,1,1,1,1,1,1,1,1,1,1,
1,1,1,1,1,1,1,1,1,1,1,1,1,1,1,1,1,1,1,1,1,1,1,1,1,1,1,1,1,1,1,
1,1,1,1,1,1,1,1,1,1,1,1,1,1,1,1,1,1,1,1,1,1,1,1,1,1,1,1,1,1,1,
1,1,1,1,1,1,1,1,1,1,1,1,1,1,1,1,1,1,1,1,1,1,1,1,1,1,1,1,1,1,1,