1,1,1,1,1,1,1,1,1,1,1,1,1,1,1,1,1,1,1,1,1,1,1,1,1,1,1,1,1,1,1,1,1,
1,1,1,1,1,1,1,1,1,1,1,1,1,1,1,1,1,1,1,1,1,1,1,1,1,1,1,1,1,1,1,1,1,
1,1,1,1,1,1,1,1,1,1,1,1,1,1,1,1,1,1,1,1,1,1,1,1,1,1,1,1,1,1,1,1,1,
1,1,1,1,1,1,1,1,1,1,1,1,1,1,1,1,1,1,1,1,1,1,1,1,1,1,1,1,1,1,1,1,1,
1,1,1,1,1,1,1,1,1,1,1,1,1,1,1,1,1,1,1,1,1,1,1,1,1,1,1,1,1,1,1,1,1,
1,1,1,1,1,1,1,1,1,1,1,1,1,1,1,1,1,1,1,1,1,1,1,1,1,1,1,1,1,1,1,1,1,
1,1,1,1,1,1,1,1,1,1,1,1,1,1,1,1,1,1,1,1,1,1,1,1,1,1,1,1,1,1,1,1,1,
1,1,1,1,1,1,1,1,1,1,1,1,1,1,1,1,1,1,1,1,1,1,1,1,1,1,1,1,1,1,1,1,1,
1,1,1,1,1,1,1,1,2,2,2,2,2,2,2,2,2,2,2,2,2,2,2,2,2,1,1,1,1,1,1,1,1,
1,1,1,1,1,1,1,1,2,3,3,3,3,3,3,3,3,2,3,3,5,6,3,3,2,1,1,1,1,1,1,1,1,
1,1,1,1,1,1,1,1,2,3,23,23,23,3,3,3,3,2,3,3,3,3,3,3,2,1,1,1,1,1,1,1,1,
1,1,1,1,1,1,1,1,2,7,24,24,24,10,7,7,7,3,7,7,7,7,7,7,2,1,1,1,1,1,1,1,1,
1,1,1,1,1,1,1,1,2,7,7,7,7,8,7,7,7,3,7,10,7,10,7,10,2,1,1,1,1,1,1,1,1,
1,1,1,1,1,1,1,1,2,7,7,7,7,7,7,7,7,7,7,8,7,8,7,8,2,1,1,1,1,1,1,1,1,
1,1,1,1,1,1,1,1,2,7,7,7,7,7,7,7,7,2,7,10,7,10,7,10,2,1,1,1,1,1,1,1,1,
1,1,1,1,1,1,1,1,2,7,21,7,7,7,7,7,7,2,7,8,7,8,7,8,2,1,1,1,1,1,1,1,1,
1,1,1,1,1,1,1,1,2,7,22,7,7,7,7,9,9,2,7,10,7,10,7,10,2,1,1,1,1,1,1,1,1,
1,1,1,1,1,1,1,1,2,7,7,7,7,7,7,9,9,2,7,8,7,8,7,8,2,1,1,1,1,1,1,1,1,
1,1,1,1,1,1,1,1,2,2,2,2,2,2,2,2,2,2,2,2,2,2,2,2,2,1,1,1,1,1,1,1,1,
1,1,1,1,1,1,1,1,3,3,3,3,3,3,3,3,3,3,3,3,3,3,25,3,3,1,1,1,1,1,1,1,1,
1,1,1,1,1,1,1,1,3,3,3,3,3,3,3,3,3,3,3,3,3,3,26,3,3,1,1,1,1,1,1,1,1,
1,1,1,1,1,1,1,1,1,1,1,1,1,1,1,1,1,1,1,1,1,1,1,1,1,1,1,1,1,1,1,1,1,
1,1,1,1,1,1,1,1,1,1,1,1,1,1,1,1,1,1,1,1,1,1,1,1,1,1,1,1,1,1,1,1,1,
1,1,1,1,1,1,1,1,1,1,1,1,1,1,1,1,1,1,1,1,1,1,1,1,1,1,1,1,1,1,1,1,1,
1,1,1,1,1,1,1,1,1,1,1,1,1,1,1,1,1,1,1,1,1,1,1,1,1,1,1,1,1,1,1,1,1,
1,1,1,1,1,1,1,1,1,1,1,1,1,1,1,1,1,1,1,1,1,1,1,1,1,1,1,1,1,1,1,1,1,
1,1,1,1,1,1,1,1,1,1,1,1,1,1,1,1,1,1,1,1,1,1,1,1,1,1,1,1,1,1,1,1,1,
1,1,1,1,1,1,1,1,1,1,1,1,1,1,1,1,1,1,1,1,1,1,1,1,1,1,1,1,1,1,1,1,1,
1,1,1,1,1,1,1,1,1,1,1,1,1,1,1,1,1,1,1,1,1,1,1,1,1,1,1,1,1,1,1,1,1,