1,1,1,1,1,1,1,1,1,1,1,1,1,1,1,1,1,1,1,1,1,1,1,1,1,1,1,1,1,1,1,
1,1,1,1,1,1,1,1,1,1,1,1,1,1,1,1,1,1,1,1,1,1,1,1,1,1,1,1,1,1,1,
1,1,1,1,1,1,1,1,1,1,1,1,1,1,1,1,1,1,1,1,1,1,1,1,1,1,1,1,1,1,1,
1,1,1,1,1,1,1,1,1,1,1,1,1,1,1,1,1,1,1,1,1,1,1,1,1,1,1,1,1,1,1,
1,1,1,1,1,1,1,1,1,1,1,1,1,1,1,1,1,1,1,1,1,1,1,1,1,1,1,1,1,1,1,
1,1,1,1,1,1,1,1,1,1,1,1,1,1,1,1,1,1,1,1,1,1,1,1,1,1,1,1,1,1,1,
1,1,1,1,1,1,1,1,1,1,1,1,1,1,1,1,1,1,1,1,1,1,1,1,1,1,1,1,1,1,1,
1,1,1,1,1,1,1,1,1,1,1,1,1,1,1,1,1,1,1,1,1,1,1,1,1,1,1,1,1,1,1,
1,1,1,1,1,1,1,1,1,1,13,13,13,13,13,13,13,13,13,13,13,1,1,1,1,1,1,1,1,1,1,
1,1,1,1,1,1,1,1,1,1,13,14,15,14,15,14,13,14,15,14,13,1,1,1,1,1,1,1,1,1,1,
1,1,1,1,1,1,1,1,1,1,13,16,16,16,16,23,13,16,16,16,13,1,1,1,1,1,1,1,1,1,1,
1,1,1,1,1,1,1,1,1,1,13,9,9,7,7,24,14,21,7,21,13,1,1,1,1,1,1,1,1,1,1,
1,1,1,1,1,1,1,1,1,1,13,9,7,8,7,7,16,22,7,22,13,1,1,1,1,1,1,1,1,1,1,
1,1,1,1,1,1,1,1,1,1,13,7,8,10,8,7,7,7,7,7,13,1,1,1,1,1,1,1,1,1,1,
1,1,1,1,1,1,1,1,1,1,13,7,7,8,7,7,13,21,7,21,13,1,1,1,1,1,1,1,1,1,1,
1,1,1,1,1,1,1,1,1,1,13,11,7,7,11,7,13,22,7,22,13,1,1,1,1,1,1,1,1,1,1,
1,1,1,1,1,1,1,1,1,1,13,13,13,13,13,13,13,13,13,13,13,1,1,1,1,1,1,1,1,1,1,
1,1,1,1,1,1,1,1,1,1,14,14,14,14,14,25,14,14,14,14,14,1,1,1,1,1,1,1,1,1,1,
1,1,1,1,1,1,1,1,1,1,16,16,16,16,16,26,16,16,16,16,16,1,1,1,1,1,1,1,1,1,1,
1,1,1,1,1,1,1,1,1,1,1,1,1,1,1,1,1,1,1,1,1,1,1,1,1,1,1,1,1,1,1,
1,1,1,1,1,1,1,1,1,1,1,1,1,1,1,1,1,1,1,1,1,1,1,1,1,1,1,1,1,1,1,
1,1,1,1,1,1,1,1,1,1,1,1,1,1,1,1,1,1,1,1,1,1,1,1,1,1,1,1,1,1,1,
1,1,1,1,1,1,1,1,1,1,1,1,1,1,1,1,1,1,1,1,1,1,1,1,1,1,1,1,1,1,1,
1,1,1,1,1,1,1,1,1,1,1,1,1,1,1,1,1,1,1,1,1,1,1,1,1,1,1,1,1,1,1,
1,1,1,1,1,1,1,1,1,1,1,1,1,1,1,1,1,1,1,1,1,1,1,1,1,1,1,1,1,1,1,
1,1,1,1,1,1,1,1,1,1,1,1,1,1,1,1,1,1,1,1,1,1,1,1,1,1,1,1,1,1,1,
1,1,1,1,1,1,1,1,1,1,1,1,1,1,1,1,1,1,1,1,1,1,1,1,1,1,1,1,1,1,1,