1,1,1,1,1,1,1,1,1,1,1,1,1,1,1,1,1,1,1,1,1,1,1,1,1,1,1,
1,1,1,1,1,1,1,1,1,1,1,1,1,1,1,1,1,1,1,1,1,1,1,1,1,1,1,
1,1,1,1,1,1,1,1,1,1,1,1,1,1,1,1,1,1,1,1,1,1,1,1,1,1,1,
1,1,1,1,1,1,1,1,1,1,1,1,1,1,1,1,1,1,1,1,1,1,1,1,1,1,1,
1,1,1,1,1,1,1,1,1,1,1,1,1,1,1,1,1,1,1,1,1,1,1,1,1,1,1,
1,1,1,1,1,1,1,1,1,1,1,1,1,1,1,1,1,1,1,1,1,1,1,1,1,1,1,
1,1,1,1,1,1,1,1,1,1,1,1,1,1,1,1,1,1,1,1,1,1,1,1,1,1,1,
1,1,1,1,1,1,1,1,1,1,1,1,1,1,1,1,1,1,1,1,1,1,1,1,1,1,1,
1,1,1,1,1,1,1,1,1,1,13,13,13,13,13,13,13,1,1,1,1,1,1,1,1,1,1,
1,1,1,1,1,1,1,1,1,1,13,14,15,14,1,4,13,1,1,1,1,1,1,1,1,1,1,
1,1,1,1,1,1,1,1,1,1,13,16,16,23,16,16,13,1,1,1,1,1,1,1,1,1,1,
1,1,1,1,1,1,1,1,1,1,13,21,7,24,8,21,13,1,1,1,1,1,1,1,1,1,1,
1,1,1,1,1,1,1,1,1,1,13,22,7,7,7,22,13,1,1,1,1,1,1,1,1,1,1,
1,1,1,1,1,1,1,1,1,1,13,13,13,7,13,13,13,1,1,1,1,1,1,1,1,1,1,
1,1,1,1,1,1,1,1,1,1,14,14,14,19,14,14,14,1,1,1,1,1,1,1,1,1,1,
1,1,1,1,1,1,1,1,1,1,16,16,16,20,16,16,16,1,1,1,1,1,1,1,1,1,1,
1,1,1,1,1,1,1,1,1,1,1,1,1,1,1,1,1,1,1,1,1,1,1,1,1,1,1,
1,1,1,1,1,1,1,1,1,1,1,1,1,1,1,1,1,1,1,1,1,1,1,1,1,1,1,
1,1,1,1,1,1,1,1,1,1,1,1,1,1,1,1,1,1,1,1,1,1,1,1,1,1,1,
1,1,1,1,1,1,1,1,1,1,1,1,1,1,1,1,1,1,1,1,1,1,1,1,1,1,1,
1,1,1,1,1,1,1,1,1,1,1,1,1,1,1,1,1,1,1,1,1,1,1,1,1,1,1,
1,1,1,1,1,1,1,1,1,1,1,1,1,1,1,1,1,1,1,1,1,1,1,1,1,1,1,
1,1,1,1,1,1,1,1,1,1,1,1,1,1,1,1,1,1,1,1,1,1,1,1,1,1,1,
1,1,1,1,1,1,1,1,1,1,1,1,1,1,1,1,1,1,1,1,1,1,1,1,1,1,1,